100
100
PPPPPPPPPPPPPPPPPPPPPPPPPPPPPPPPPPPPPPPPPPPPPPPPPPPPPPPPPPPPPPPPPPPPPPPPPPPPPPPPPPPPPPPPPPPPPPPPPPPP
PPPPPPPPPPPPPPPPPPPPPPPPPPPPPPPPPPPPPPPPPPPPPPPPPPPPPPPPPPPPPPPPPPPPPPPPPPPPPPPPPPPPPPPPPPPPPPPPPPPP
PPPPPPPPPPPPPPPPPPPPPPPPPPPPPPPPPPPPPPPPPPPPPPPPPPPPPPPPPPPPPPPPPPPPPPPPPPPPPPPPPPPPPPPPPPPPPPPPPPPP
PPPTTTSSTTTSSTTTTTTTTTTTTTSSTTTTTTTTTTTTTTTTTTTTTTTTTTTTTTTTTTSSTTTTAATTTTTTTTTTTTTTTTTTTTSSTTTTKPPP
PPPTTTSSTTTTSSTTTTTTTTTTTTSSTTTTTTTTTTTTTTTTTTTTTTTTTTTTTTTTTTTSSTTAATTTTTTTTTTTTTTTTTTTTSSTTTTTTPPP
PPPTTTTSSTTSSTTTTTTTTTTTTTTSSTTTTTTTTTTTTTTTTTTTTTTTTTTTTTTTTTBSSBBAABBBTTTTTTTTTTTTTTTTTSSTTTTTKPPP
PPPTTTTSSTSSTTTTTTTTTTTTTTTSSTTTTTTTTTTTTTTTTTTTTTTTTTTTTTTTTTSSSSBBAABBTTTTTTTTTTTTTTTTTSSTTTTTTPPP
PPPTTTTSSTTSSTTTTTTTTTTTTTTTSSTTTTTTTTTTTTTTTTTTTTTTTTTTTTTTTTBSSBBAABBBTTTTTTTTTTTTTTTTTSSTTTTTTPPP
PPPSTTSSTTTSSTTTTTTTTTTTTTTTSSTTTTTTTTTTTTTTTTTTTTTTTTTTTTTTTTSSBBAABBBBTTTTTTTTTTTTTTTTTTSSTTTTTPPP
PPPSSTTSSTSSSSSSTTTTTTTTTTTTTSSTTTTTTTTTTTTTTTTTTTTTTTTTTTTBBBBSSAABBBBSSSSSSSSSSSSSSTTTTTTSSTTTTPPP
PPPTSSSSSSSSSSSSSSTSTSTTTTTTTTSSTTTTTTTTTTTTTTTTTTTTTTTTTTTBBBBBSSBBBBBSSSSSSSSSSSSSSTTTTTTSSTTTTPPP
PPPTTSSTTSSSTTTTSSSSSSSSSTTTTTSSTTTTTTTTTTTTTTTTTTTTTTTTTTTBBBBSSAABBBBSSSAAAAAAAASSSBBTTTTSSTTTTPPP
PPPTTTSSTTTSSTTTTTSTSTSSSSSTTSSTSTTTTTTTTTTTTSSTTTTTTTTTTTTBBBBBSSBBBBBSSSSSSSSSSSSSSBBTTTTSSTTTTPPP
PPPTTTSSTTSSTTTTTTTTTTTTTSSSTTSSSSTTTTTSTTTTSSSSKTTTTTTTTTTBBBBSSBBBBBBSSSAAAAAAAASSSBBTTTTSSTTTTPPP
PPPTTSSTTSSTTTTTTTTTTTTTTTTSSSSSTSSTTTSSSSTSSTTSSSTTTTTTTTTBBBBBSSBBBBBSSSSSSSSSSSSSSBBTTTSSTTTTTPPP
PPPTTSSTSSTTTTTTTTTTTTTTTTTTSSTTTTSSTSSTSSSSTTTTSSSSSTSTTTTBBBBSSSSBBBBSSSAAAAAAAKSSSBBTTTTSSTTTTPPP
PPPTTTSSSSTTTTTTTTTTTTTTTSSSSSSSSSSSSSSTTTSTTTTTTTSSSSSSTTTBBBBSSSSBBBBSSSSSSSSSSSSSSBBTTTSSTTTTTPPP
PPPTTTTSSTTTTTTTTTTTTTTTTSSSSSSSSSSSSSSTTTTTTTTTTTTTTSTSSSTBBBBSSSSBBBBSSSAAAAAAAASSSBBTTTTSSTTTTPPP
PPPTTTSSSSTTTTTTTTTTTTTTTSSAAAAAAAAAASSTTTTTTTTTTTTTTTTTSSSBBBBBSSBBBBBSSSSSSSSSSSSSSBBTTTTSSTTTTPPP
PPPTTTTTSSTTTTTTTTTTTTTTTSSAAAAAAAAAASKTTTTTTTTTTTTTTTTTTTSSBBBSSSBBBBKSSSAAAAAAAASSSBBTTTTTSTSTTPPP
PPPTTTTSSSSTTTTTTTTTTTTTTSSAAAAAAAAAASSTTTTTTTTTTTTTTTTTTTTSSBSSSSSBBBBSSSSSSSSSSSSSSBBTTTTSSSSSTPPP
PPPTTTSSSSTTTTTTTTTTTTTTTSSAAASSSSAAASSTTTTTTKTTTTTTTTTTTTTBSSSBSSSSSBBSSSSSSSSSSSSSSSSSSSSSTSTSSPPP
PPPTTTTSSSSTTTTTTTTTTTTTTSSAAASTTSAAASSTTTTTTTTTTTTTTTTTTTTBBSBBBSSSSSSSSSSSSSSSSSSSSSMMMMMMSSTTSPPP
PPPTTTTSSTSSTTTTTTTTTTTTTSSAAASTTSAAASSTTTTTTTTTTTTTTTTTTTTBBBBBAASSBSSSSSSSSSSSSSSSBSMAAAAMSSTSTPPP
PPPSSSSSSSSSSSSSSSSSKTTTTSSAAASSSSAAASSTTTTTTTTTTTTTTTTTTTTBBBBAABBSSSBSSSBBSSSSBBSSBSMAAAAMSSSSTPPP
PPPSSSSSSSSSSSSSSSSSTTTTTSSAAAAAAAAAASSTTTTTTTTTTTTTTTTTTTTBBSSBAASSSSBBBBBBBBBBBBBBBSMAAAAMSSSTTPPP
PPPSAAAAAAAAAASSSSSSTTTTTSSAAAAAAAAAASSTTTTTTTTTTTTTTTTTTTTSSSSAASSBSBBBBBBBBBBBBBBBBSMAAAAMSSTTTPPP
PPPAAAAAAAAAAAAASSSSTTTTTSSAAAAAAAAAASSTTTTTTTTTTTTTTTTTSTSSSTTAATSSTTTTTTTTTTTTTTTTTSMAAAAMTSSTTPPP
PPPAAAAAAAAAAAAAASSSSSSSSSSSSSSSSSSSSSSTTTTTTTTTTTTTTTTSSSSTTTAASSTSSTTTBBBBBBBBBBBBBSMAAAAMTTSSTPPP
PPPAAAASAASSSAAAASSSSSSSSSSSSSSSSSSSSSSTTTTTTTTTTTTTTTSSTSTTTAATTSSSSTTTBBBBBBBBBBBBBSMAAAAMTTTSSPPP
PPPAAAASSSSSSSAAASSSSSSSSSSTTTTTTTTTTTTTTTTTTTTTTTTTTSSTTTTTTTAATTSSTTTTBBBBAAAAAABBBSMAAAAMTTSSTPPP
PPPAAAASSSSSSSAAAASSSSSSSSTTTTTTTTTTTTTTTTTTTTTTTTSTSSTTTTTTTTAATSSSSTTTBBBAAAAAAAABBSMAAAAMTTSSTPPP
PPPAAAASSSAAAAAAAAASSSSSSSBBBTTTTTTTTTTTTTTTTTTTTSSSSTTTTTTTTTTAATSSTTTTBBAAAAAAAAABBSMAAAAMTTTSSPPP
PPPAAAASASSAAAAAAAASSSSSSSSBBTTTTTTTTTTTTTTTTTSTSSTSTTTTTTTTTTAATSSTTTTTBBAAAAAAAAABBSMAAAAMTTTSSPPP
PPPAAAAAAAAAAAAAAAASSSSSSSSSSSSSSSSSSSSSSSSSTSSSSTTTTTTTTTTTTTAATSSTTTBBBBAAAAAAAAABBSMAAAAMTTSSTPPP
PPPAAAAAAAAAAAAAAAASSSSSMMMMMMMMMMMMMMMMSSSSSSTSTTTTTTTTTTTTTTAASSSSTTBBBBAAAAABAABBBSMAAAAMTTTSSPPP
PPPSSSAAAAAAAAAAAASSSSSSMSSSSSSSSSSSSSSMSTTTSTTTTTTTTTTTTTTTTTTAATSSTTBBBBBBBBBBBBBBBSMAAAAMTTSSTPPP
PPPSSSSSAAAAAAAAASSSSSSSMSSSSSSSSSSSSSSMSTTTTTTTTTTTTTTTTTTTTTTTAASSTTBBBBBBBBBBBBBBBSMMMMMMTSSTSPPP
PPPSSSSSSSSAAASSSSSSSSSSMSSSSSSSSSSSSSSMSTTTTTTTTTTTTTTTTTTTTTTAASSTTTBBBBBBBBSSBBBBBSSSSSSSSSSSSPPP
PPPSSSSSSSSSSSSSSSSSSSSSMSSSSSSSSSSSSSSMSTTTTTTTTTTTTTTTTTTTTTTTTSSTTTBBBBBBBSSSSBBBBBBBBSSSSSSSSPPP
PPPSSSSSSSSSSSSSSSSSSBBSMSSSSSBBBBBSSSSMSTTTTTTTTTTTTTTTTTTTSSTTAASSTTBBSBBBSSBBSSBBBBBBBSSTTSSTTPPP
PPPSSSBSBSSSSSSSSSSSSSBSMSSSSBBTTTBBSSSMSSTTTTTTTTTTTTTTTTSSSSSSTSSSTTBSSBSSSBBBBSSSSSBSBSTTTSTTTPPP
PPPTTTBBBBBSSBBBBBBBBSSSMSSSSBBBBBBBSSSMSSTTTTTTTTTTTTTTTSSSSTSSSSTSSTSSBSSSBBBBBBSSSSSSSSTTTSTTTPPP
PPPTTBBBBBSSBSBBBSBBBSSSMSSSSBTBBTBBBSSMSSSSSSSSSSSSSSSSSSTTSTTTSSSSSSSSSSSSSBBBBBBBBBSSSSTTTSTTTPPP
PPPSTBBBBBSSSSSBSSSBSSBSMSSSBBBBBBBBBBSMMMMMMMMMMMMMMMMMSTTTTTTTTSSTTSSSSBSSSSSSBBBBBBBBBSTTTSTTTPPP
PPPSSBBBBSSSSBSSSBSSSBBSMSSSSBBBBBBBBBBBBBBBBBBBTTSSSSSMSTTTTTTTTSSTTTSBBBBBBSSSSBBBBBBBBSTTTSTTTPPP
PPPTSSSBSSSSBBBSBBBSBBBSMSSSSSBTTBBBBBBBBBBBBBBTTTSSSSSMSTTTTTTTTSSTTTBBBBBBBBBBSSBBBBBBBSTSSSTTTPPP
PPPTTSSSSTSSBBBBBBBBBBBSMSSSSSBBBBBBBBBBBBBBBBTTTSSSSSSMSTTTTTTTTSSTTTBBBBBBBBBBBSSSSBBBBSSSTTTTTPPP
PPPTTTTSTSSBBBBBBBBBBBBSMSSSSSSSSSSSSBBBBBBBTTTTSSSSSSSMSTTTTTTTSSTTTTBBBBBBBBBBBBSSSSBBBSSTTTSSTPPP
PPPTTTTTTSSBBBBBBBBBBBBSMSSSSSSSSSSSSSSSBTTTTTTSSSSSSSSMSTTTTTTTTSSTTTBBBBBBBBBBBBBBBSSSBSSSTSSSSPPP
PPPTTTTTSSBBBBBBBBBBBBBSMMMMMMMMMMMMMMMMMTTTTSSSSSSSSSSMSTTTTTTTTTSTTTBBBBBBBBBBBBBBBBSSBSSSSSTTSPPP
PPPTTTTSSSSBBBBBBBBBBBBSSSSSSSSSSSSSSSSSMTSSSSSSSSSSSSSMSTTTTTTTTTSSTTBBBBBBBBBBBBBBBBBSSSTTSTTTTPPP
PPPTTTSSSSBBBBBBBBBBBBBBSSBBBBBBBBBTAATSMSSSSSSSSSSSSSSMSTTTTTTTTTSSTTBBBBBBBBBBBBBBBBBBSSTTTTTTTPPP
PPPTTTSSSSTTTTTTTTTBBBBSSBBBBBBBBBBTAATSMSSSSSSSSSSSSSSMSTTTTTTTTSSTTTBBBBBBBBBBBBBBBBBBBTTTTTTTTPPP
PPPTTSSSSTTTTTTTTTTBBBSSBBBBBBBBBBBTAATSMSSSSSSSSSSSSSSMSBBBBBBSSSBBBBBBBBBBBBBBBBBBBBBBBTTTTTTTTPPP
PPPTSSTTSSTTTTTTTKTBBBBSSSSSSSSSSSSSSSSSMSSSSSSSSSSSSSSMSBBBBSSSSSBBBBBBBBBBBBBBBBBBBBBBBTTTTTTTTPPP
PPPTSSTTTSSTTTTTTTTBBBBSMMMMMMMMMMMMMMMMMSSSSSSSSSSSSSSMSBBBBBBBSSBBBBBBBBBBBBBBBBBBBBBBBTTTTTTTTPPP
PPPSSTTTTTSSTTTTTTTBBBBSMSSSSSSSSSSSSSSSSSSSSSSSSSSSSSSMSBBBBSSSSSSBBBBBBBBBBBBBBBBBBBBBBTTTTTTTTPPP
PPPTSSTTTSSTTTTTTTTBBBBSMSSSSSSSSSSSSSSSSSSSSSSSSSSSSSSMSBBBBBBBSASSBBBBBBBBBBBBBBBBBBBBBTTTTTTTTPPP
PPPSSTTTSSTTTTTTTTTBBBBSMSSSSSSSSSSSSSSMMMMMMMMMMMMMMMMMSBBBBSSSSAASSBBBBBBBBBBBBBBBBBBBBTTTTTTTTPPP
PPPSSTTTTSSTTTTTTTTBBBBSMSMMMSSSMMMMSSSMSSSSSSSSSSSSSSSSSBBBBSSSAAASSSBBBBBBBBBBBBBBBBBBBTTTTTTTTPPP
PPPSSTTTTTSSTTTTTTTBBBBSMSSMSSSSMSSMSSSMSBBBBBBBBBBBBBBBBBBBBBSSSAASSBBSSSSSSSSSSSSSSSSSSAAAAAAAAPPP
PPPTTTTTTTSSTTTTTTTBBBBSMSSMSSSSMSSMSSSMSBBBBBBBBBBBBBBBBBBBBBBBSSSSBBBSSSSSSSSSSSSSSSSSSAAAAAAAAPPP
PPPTTTTTTSSTTTTTTTKBBBBSMSSMSSSSMSSMSSSMSBBBBBBBBBBBBBBBBBBBBBBBBSSBBBBSSSAAASAAASASAAASSAAAAAAAAPPP
PPPTTTTTSSTTTTTTTTTBBBBSMSSMSSSSMMMMSSSMSBBBBBBBBBBBBBBBBBBBBBBBSSSBBBBSSSSSASASASASSSASSAAAAAAAAPPP
PPPTTTTTSSTTTTTTTTTBBBBSMSSMSSSSMSSMSSSMSBBBBBBBBBBBBBBBBBBBBBBBBSSAAAASSSAAASASASASSSASSAAASSSSSPPP
PPPTTTTTSSTTTTTTTTTBBBBSMSSMSSSSMSSMSSSMSBKBBBBBBBBBBBBBBBBBBBBBBSSSAAASSSASSSASASASSSASSAAASSSSSPPP
PPPTTTTTTSSTTTTTTTTTTBBSMSMMMSKSMSSMSKSDSBBBBBBBBBBBBBBBBBBBBBBBBSSBBAASSSAAASAAASASSSASSAAASSAAAPPP
PPPTTTTTSSTTTTTTTTTTTBBSMSSSSSSSSSSSSSSDSBBBBBBBBBBBBBBBBBBBBBBBSSBBBBBSSSSSSSSSSSSSSSSSSAAASSASSPPP
PPPTTTTSSTTTTTTTTTTTTBBSMSSSSSSSSSSSSSSDSBBBBBBBBBBBBBBBBBBBBBBBBSSBBBBSSSSSSSSSSSSSSSSSSAAASSASSPPP
PPPTTTSSTTTTTTTTTTTTTBBSMSSSSSSSSSSSSSSMSTTTTTTTTTTTTTTTTTTTTTTTTTSSBBBSSSPPPPPPPPPPPSSPPPPPPPPPPPPP
PPPTTTTSSTTTTTTTTTTTTBBSMMMMMMMMMMMMMMMMSTTBBBBBBBBBBBBBBTTTTTTTTAASSBBSSSPPPPPPPPPPPSSPPPPPPPPPPPPP
PPPTTTTSSTTTTTTTTTTTTBBSSSSSSSSSSSSSSSSSSTTBBBBBBBBBBBBBBTTTTTTTTTAASSTSSSPPMMMMMMMMMDDMMMMMMMMMMPPP
PPPTTTTSSTTTTTTTTTTTTBSSBBBBBBBBBBBBBBBBTTTBBBBBBBBBBBBBBTTTTTTTTSSSSTTSSSPPMSSSSSSSSSSTTTTTTTTTMPPP
PPPTTTSSTTTTTTTTTTTTTBSSBBBBBBBBBBBBBBBBTTTBBBBBBBBBBBBBBTTTTTTTSSTSSTTSSSPPMSSSSSSSSSSSTTTTTTTTMPPP
PPPTTTSSTTTTTTTTTTTTTBBSSBBBBBBBBBBBBBBBTTTBBKBBBBBBBBBBBTTTTTTTTSSSSTTSSSPPMSSSSSSSSSSSSTTTTTTTMPPP
PPPTTTTSSTTTTTTTTTTKTTTTMMMMMMMMMMMMMMMMMMMMMMMMMMMMMMMMMMMMMTTTSSTSSTTSSSPPMSSSSSSSSSSTSSTTTTTTMPPP
PPPTTTSSTTTTTTTTTTTTTTTTSSBBBBBBBBBBBBBBTTTBBBBBBBBBBBBBBTTTMTTTSSAASSTTTTAAATTTTTTSSTTTTSSTTTTTMPPP
PPPTTTSSATTTTTTTTTTTTTTSSBBBBBBBABAAKBBBTTTBBBBBBBBBABBBBTTKMTTSSAATTSSTAAAAAAATATSSTTTTTTSTSTTTMPPP
PPPSTASSAATTTTAATTTTTTABSSBBBBBAAAAAABBBBBBBBBBBABBAAABABAATMTTATTAAASSAAAPPMAAAAASATAATTSSSSSSSMPPP
PPPSSASSTAAAAAAAAATTTAAASSBBABAABABBAAABBBBBBBBAAAAABAAAAAAAMSSATTTAASSASTPPMTTATAAAAAATSSSSASSSMPPP
PPPTSTSSSTAAAATTAATTAATAABAAAAABBBBBBAAAABBBABAABAASBSABATTAMSSSSSSATSSSSSPPMTTTTTATATSSSTTTATTSMPPP
PPPTTSSTSSTTSTTTSSSSATTBAAAABABBBBBBBBBAAAAAAAASBSBSSSBBSTTSMTTSSSSSSTSSSSPPMTTTSSSTSSSSTTTTTTTTMPPP
PPPTTSSTSSSSSSTSSSSSSTSBBASSSBBBBSSSSBBBBAAASABSSSBSSBBSSSSSMTTSSTTSSSSTSTPPMSBSSSSSSSBBBBTTTTTTMPPP
PPPSSSSSSTSSTSSSTTTTSSSSSBSSSSBBSSSSSSBBBSSBSBBSSSSSSBSSMSMTMTSSTTTAASTTTTPPMSSSBBBSBBBBBBTTTTTTMPPP
PPPSSSSSTTTTTTSTTTTTTSTSSSSBBSSSSBSSSSBBSSSBSBSSBSSBSSSTMSMTMTTSSTTTTSSTTTPPMTSBBBBBBBBBBBTTTTTTMPPP
PPPTTTSSTTTTTTTTTTTTTTTBBSSSSSSSSSSSSSSSSSBSSSSBBBBBBSTTMTMTMTTSSTTTSSTTTTPPMTBBBBBBBBBBBBTTTTTTMPPP
PPPTTTTSSTTTTTTTTTTTTTTBBSSSSSBBSSBBBSSSSSSSBSBBBBBBBTTTMTMTMTSSTTTTSSTTTTPPMTBBBBBBBBBBBBTTTTTTMPPP
PPPTTTSSTTTTTTTTTTTTTTTBSSBBBBBBBBBBBBBBSBSBBBBBBBBBBTTTMTMTMTSSTTTTTSSTTTPPMTBBBBBBBBBBBBTTTTTTMPPP
PPPTTTTSSKTTTTTTTTTTTTTBMSSBBBMMMMMMMMMMMMMMMMMMMMMMMMMTMTMTMTSSTTTTSSTTTTPPMTBBBBBBBBBBBBTTTTTTMPPP
PPPTTTTTSSTTTTTTTTTTTTTTMSTTTTMTTTTTTTTTTTTTTTTKTTTTTTTTMTMTMSSTTTTSSTTTTTPPMTTTTTTTTTTTTTTTTTTTMPPP
PPPTTTTSSTTTTTTTTTTTTTTTMSTTTTMTTTTTTTTTTTTTTTTTTTTTTTTTMTMTMSSTTTTTSSTTTTPPMTTTTTTTTTTTTTTTTTTTMPPP
PPPTTTTTSSTTTTTTTTTTTTTTMSSTTTMTTTTTTTTTTTTTTTTTTTTTTTTTMTMMMSSTTTTTTSSTTTPPMTTTTTTTTTTTTTTTTTTTMPPP
PPPTTTTSSTTTTTTTTTTTTTTTMTSSTTMMMMMMMMMMMMMMMMMMMMMMTTTTMTTTSSTTTTTTSSTTTTPPMTTTTTTTTTTTTTTTTTTTMPPP
PPPTTTSSTTTTTTTTTTTTTTTTMTSSTTTTTTTTTTTTTTTTTTTTTTTMTTTTMTTSSTTTTTTTTSSTTTPPMTTTTTTTTTTTTTTTTTTTMPPP
PPPTTTTSSTTTTTTTTTTTTTTTMSSTTTTTTTTTTTTTTTTTTTTTTTTMTTTTMTTSSTTTTTTTAASSTTPPMKTTTTTTTTTTTTTTTTTKMPPP
PPPTTTTTSSTTTTTTTTTTTTTTMTSSTTTTTTTTTTTTTTTTTTTTTTTMTTTTMTTTSSTTTTTAASSTTTPPMMMMMMMMMMMMMMMMMMMMMPPP
PPPPPPPPPPPPPPPPPPPPPPPPPPPPPPPPPPPPPPPPPPPPPPPPPPPPPPPPPPPPPPPPPPPPPPPPPPPPPPPPPPPPPPPPPPPPPPPPPPPP
PPPPPPPPPPPPPPPPPPPPPPPPPPPPPPPPPPPPPPPPPPPPPPPPPPPPPPPPPPPPPPPPPPPPPPPPPPPPPPPPPPPPPPPPPPPPPPPPPPPP
PPPPPPPPPPPPPPPPPPPPPPPPPPPPPPPPPPPPPPPPPPPPPPPPPPPPPPPPPPPPPPPPPPPPPPPPPPPPPPPPPPPPPPPPPPPPPPPPPPPP
