100
100
PPPPPPPPPPPPPPPPPPPPPPPPPPPPPPPPPPPPPPPPPPPPPPPPPPPPPPPPPPPPPPPPPPPPPPPPPPPPPPPPPPPPPPPPPPPPPPPPPPPP
PPPPPPPPPPPPPPPPPPPPPPPPPPPPPPPPPPPPPPPPPPPPPPPPPPPPPPPPPPPPPPPPPPPPPPPPPPPPPPPPPPPPPPPPPPPPPPPPPPPP
PPPPPPPPPPPPPPPPPPPPPPPPPPPPPPPPPPPPPPPPPPPPPPPPPPPPPPPPPPPPPPPPPPPPPPPPPPPPPPPPPPPPPPPPPPPPPPPPPPPP
PPPTTTSSTTTSSTTTTTTTTTTTTTSSTTTTTTTTTTTTTTTTTTTTTTTTTTTTTTTTTTSSSSSSAATTTTTTTTTTTTTTTTTTTTSSTTTTKPPP
PPPTTTSSTTTTSSTTTTTTTTTTTTSSTTTTTTTTTTTTTTTTTTTTTTTTTTTTTTTTTTTSSSSSATTTTTTTTTTTTTTTTTTTTSSTTTTTTPPP
PPPTTTTSSTTSSTTTTTTTTTTTTTTSSTTTTTTTTTTTTTTTTTTTTTTTTTTTTTTTTTBSSBSSSSBBTTTTTTTTTTTTTTTTTSSTTTTTKPPP
PPPTTTTSSTSSTTTTTTTTTTTTTTTSSTTTTTTTTTTTTTTTTTTTTTTTTTTTTTTTTTSSSSBSSSBBTTTTTTTTTTTTTTTTTSSTTTTTTPPP
PPPTTTTSSTTSSTTTTTTTTTTTTTTTSSTTTTTTTTTTTTTTTTTTTTTTTTTTTTTTTTBSSBBASSSBTTTTTTTTTTTTTTTTTSSTTTTTTPPP
PPPSTTSSTTTSSTTTTTTTTTTTTTTTSSTTTTTTTTTTTTTTTTTTTTTTTTTTTTTTTTSSBBAABSSSTTTTTTTTTTTTTTTTTTSSTTTTTPPP
PPPSSTTSSTSSSSSSTTTTTTTTTTTTTSSTTTTTTTTTTTTTTTTTTTTTTTTTTTTBBBBSSAABBBSSSSSSSSSSSSSSSTTTTTTSSTTTTPPP
PPPTSSSSSSSSSSSSSSTSTSTTTTTTTTSSTTTTTTTTTTTTTTTTTTTTTTTTTTTBBBBBSSBBBBBSMMSMSMMSMSMMSTTTTTTSSTTTTPPP
PPPTTSSTTSSSTTTTSSSSSSSSSTTTTTSSTTTTTTTTTTTTTTTTTTTTTTTTTTTBBBBSSAABBBBSMMMMMMMMMMMMSBBTTTTSSTTTTPPP
PPPTTTSSTTTSSTTTTTSTSTSSSSSTTSSTSTTTTTTTTTTTTSSTTTTTTTTTTTTBBBBBSSBBBBBSSSMSSSSSSMSSSBBTTTTSSTTTTPPP
PPPTTTSSTTSSTTTTTTTTTTTTTSSSTTSSSSTTTTTSTTTTSSSSKTTTTTTTTTTBBBBSSBBBBBBSSSMSSSSSSMSSSBBTTTTSSTTTTPPP
PPPTTSSTTSSTTTTTTTTTTTTTTTTSSSSSTSSTTTSSSSTSSTTSSSTTTTTTTTTBBBBBSSBBBBBSSSMSSSSSSMSSSBBTTTSSTTTTTPPP
PPPTTSSTSSTTTTTTTTTTTTTTTTTTSSTTTTSSTSSTSSSSTTTTSSSSSTSTTTTBBBBSSSSBBBBSMMMTTTTTTMMMSBBTTTTSSTTTTPPP
PPPTTTSSSSTTTTTTTTTTTTTTTSSSSSSSSSSSSSSTTTSTTTTTTTSSSSSSTTTBBBBSSSSBBBBSMSMTKTTKTMSMSBBTTTSSTTTTTPPP
PPPTTTTSSTTTTTTTTTTTTTTTTSSSSSSSSSSSSSSTTTTTTTTTTTTTTSTSSSTBBBBSSSSBBBBSMMMTTTTTTMMMSBBTTTTSSTTTTPPP
PPPTTTSSSSTTTTTTTTTTTTTTTSSSSSSSSSSSSSSTTTTTTTTTTTTTTTTTSSSBBBBBSSBBBBBSSSMSMSSMSMSSSBBTTTTSSTTTTPPP
PPPTTTTTSSTTTTTTTTTTTTTTTSSSAAAAAAAASSKTTTTTTTTTTTTTTTTTTTSSBBBSSSBBBBKSSSMSSMMSSMSSSBBTTTTTSTSTTPPP
PPPTTTTSSSSTTTTTTTTTTTTTTSSSAAAAAAAASSSTTTTTTTTTTTTTTTTTTTTSSBSSSSSBBBBSSMSSSSSSSSMSSBBTTTSSSSSSTPPP
PPPTTTSSSSTTTTTTTTTTTTTTTSSSAAAAAAAASSSTTTTTTKTTTTTTTTTTTTTBSSSBSSSSSBBSSMMSSSSSSMMSSSSSSSSSTSTSSPPP
PPPTTTTSSSSTTTTTTTTTTTTTTSSSAAABBAAASSSTTTTTTTTTTTTTTTTTTTTBBSBBBSSSSSSSSSSSSSSSSSSSSSSSSSSTSSTTSPPP
PPPTTTTSSTSSTTTTTTTTTTTTTSSSAAABBAAASSSTTTTTTTTTTTTTTTTTTTTBBBBBAASSBSSSSSSSSSSSSSSSBSMSMSSSSSTSTPPP
PPPSSSSSSSSSSSSSSSSSKTTTTSSSAAAAAAAASSSTTTTTTTTTTTTTTTTTTTTBBBBAABBSSSBSSSBBSSSSBBSSBSMSMSTSSSSSTPPP
PPPMMMMMMMMMMMMMMMMSTTTTTSSSAAAAAAAASSSTTTTTTTTTTTTTTTTTTTTBBSSBAASSSSBBBBBBBBBBBBBBBSMSMSTTSSSTTPPP
PPPMSSMSSSSSMSSSSSMSTTTTSSSSAAAAAAAASSSTTTTTTTTTTTTTTTTTTTTSSSSAASSBSBBBBBBBBBBBBBBBBSMSMSTTSSTTTPPP
PPPMSSMSSSSSMSSSSSMSTTTSSSSSSSSSSSSSSSSTTTTTTTTTTTTTTTTTSTSSSTTAATSSTTTTTTTTTTTTTTTTTSMSMSTTTSSTTPPP
PPPMSSMSSMSSMSSMSSMSSSSSSSSSSSSSSSSSSSSTTTTTTTTTTTTTTTTSSSSTTTAASSTSSTTTBBBBBBBBBBBBBSMSMSTTTTSSTPPP
PPPMSSMSSMSSMSSMSSMSSSSSSSSSSSSSSSSSSSSTTTTTTTTTTTTTTTSSTSTTTAATTSSSSTTTBBBBBBBBBBBBBSMSMSTTTTTSSPPP
PPPMSSMSSMSSMSSMSSMSSSSSSSSTTTTTTTTTTTTTTTTTTTTTTTTTTSSTTTTTTTAATTSSTTTTBBBBBBBBBBBBBSMSMSTTTTSSTPPP
PPPMSSMSSMSSMSSMSSMSSSSSSSTTTTTTTATTATATTTAATAAATTSTSSAATTTTTTAATSSSSTTTBBBBAABBBBBBBSMSMSTTTTSSTPPP
PPPMSSMSSMSSMSSMSSMSSSSSSSTTTTTTAAAAAAAAAAAAAAAAAAAAAAAATTTTTTTAATSSTTTTBBBBAAAABAABBSMSMSTTTTTSSPPP
PPPMSSMSSMSSMSSMSSMSSSSSSTTTTTTTAAAAAAAAAAAAAAAAAAAAAAAAATTTTTAATSSTTTTTBBBAAAAAAAABBSMSMSTTTTTSSPPP
PPPMSSMSSMSSMSSMSSMSSSSSTTTTTTTAAAAAAAAAAAAAAAAAAAAAAAAAATTTTTAATSSTTTBBBBBBAAAAAABBBSMSMSTTTTSSTPPP
PPPMSSMSSMSSMSSMSSMSSSSSTTTTTTAAAAAAAAAAAAAAAAAAAAAAAAAAATTTTTAASSSSTTBBBBBBBAAAAABBBSMSMSTTTTTSSPPP
PPPMSSMSSMSSMSSMSSMSSSSSTTTTTTAAAAAAAAAAAAAAAAAAAAAAAAAAAATTTATAATSSTTBBBBBBBBBBBBBBBSMSMSTTTTSSTPPP
PPPMSSMSSMSSMSSMSSSSSSSSTTTTTAAAAAAAATTTATAAAAAAAAAAAAAAAATTAATTAASSTTBBBBBBBBBBBBBBBSMSMSTTTSSTSPPP
PPPMSSSSSMSSSSSMSSSSSSSSTTTTAAAAAAATTTTTAAATAAAAAAAAAAAAAATTAATAASSTTTBBBBBBBBSSBBBBBSSSSSTSSSSSSPPP
PPPMSSSSSMSSSSSMSSSSSSSSTTTAAAAAAAAATSTTSTTTAAAAAAAAAAAAAAATAAAAASSTTTBBBBBBBSSSSBBBBBBBTTSSSSTSSPPP
PPPMMMMMMMMMMMMMMMMSSBBSTTTAAAAAAAASTSTTSTTTAAAAAAAAAAAAAAAAAAAAAASSTTBBSBBBSSBBSSBBBBBBTSSTTTTTTPPP
PPPSSSSSSSSSSSSSSSSSSSBSTTTAAAAAAASSTKSTSSTTAAAAAAAAAAAAAAAAASASTSSSTTBSSBSSSBBBBSSSSSBSSSTTTTTTTPPP
PPPTTTBBSSBSSBBBBBBBBSSSTTTTAAAAAASTTTTTSSTTAAAAAAAAAAAAAAAASTASSSTSSTSSBSSSBBBBBBSSSSSSSSTTTTTTTPPP
PPPTTTBBBBSSBSBBBSBBBSSSTTTTTAAAAASTTTTTSTSTAAAAAAAAAAAAAAAASAATSSSSSSSSSSSSSBBBBBBBBBSBSSTTTTTTTPPP
PPPSTTBBBBSSSSSBSSSBSSBSTTTTTTAAAAAASTTTTTTAAAAAAAAAAAAAAAAAAATTTSSTTSSSSBSSSSSSBBBBBBTTSSTTTTTTTPPP
PPPSSTTTTSSSSBSSSBSSSBBSTTTTTTAAAAAAATTTTAAAAAAAAAAAAAAAAATTTTTTTSSTTTSBBBBBBSSSSBBBBBTTSSTTTTTTTPPP
PPPTSSSTSSSSBBBSBBBSBBBSTTTTSTSAAAAAAAAAAAAAAAAAAAAAAAAAATTTTTTTTSSTTTBBBBBBBBBBSSBBBBTTSSTTTTTTTPPP
PPPTTSSSSTSSBBBBBBBBBBBSTTTSSTTTAAAAAAAAAAAAAAAAAAAAAAAATTTTTTTTTSSTTTBBBBBBBBBBBSSSSBTTSSTTTTTTTPPP
PPPTTTTSTSSBBBBBBBBBBBBSTTTTTTSSSAAAAAAAAAAAAAAAAAAAAAAATTTTTTTTSSTTTTBBBBBBBBBBBBSSSSTTSSTTTTSSTPPP
PPPTTTTTTSSBBBBBBBBBBBBSTTTSSSSTTTTAAAAAAAAAAAAAAAAAAAATTTTTTTTTTSSTTTBBBBBBBBBBBBBBBSSTSSSSTSSSSPPP
PPPTTTTTSSBBBBBBBBBBBBBSTTTTTTTTTTTAAAAAAAAAAAAAAASSTSTTTTTTTTTTTSSTTTTTTTTTTTTTTTTTTTSSSSSSSSTTSPPP
PPPTTTTSSSSBBBBBBBBBBBBSSSSSSSTTTTSSSSSSAAAAAASSSSSSTSTTTTTTTTTTTTSSTTTTTTTTTTTTTTTTTTTSSSTTSTTTTPPP
PPPTTTSSSSBBBBBBBBBBBBBBSSBBBBBBBBBTTTTSTTSSSSSSSSSSTSTTTTTTTTTTTTSSTTTTTTTTTTTTTTTTTTTTSSTTTTTTTPPP
PPPTTTSSSSTTTTTTTTTBBBBSSBBBBBBBBBBTTTTSTSSSSSSSSSSSTSSTTTTTTTTTTSSTTTTTTTTTTTTTTTTTTTTTTTTTTTTTTPPP
PPPTTSSSSTTTTTTTTTTBBBSSBBBBBBBBBBBTTBBSTSSSSSSSSSSSTSSTTBBBBBBBSSTTTTTTTTTTTTTTTTTTTTTTTTTTTTTTTPPP
PPPTSSTTSSTTTTTTTKTBBBBSSSSSSSSSSSSSSSSSSSSSSSSSSSSSTTSTTBBBBBBSSAATTTTTTTTTTTTTTTTTTTTTTTTTTTTTTPPP
PPPTSSTTTSSTTTTTTTTBBBBSMMMMMMMMMMMMMMMMSSSSSSSSSSSSSTSTTBBBBBBBSSBBBBBBBBBBBBBBBBTTTTTTTTTTTTTTTPPP
PPPSSTTTTTSSTTTTTTTBBBBSMTTTTTTTTTTTTTTMSSSSSTTTTTTTTTSTTBBBBBBSSSSBBBBBBBBBBBBBBBTTTTTTTTTTTTTTTPPP
PPPTSSTTTSSTTTTTTTTBBBBSMTTTTTTTTTTTTTTMSSSTTTTTTTTTTTTTTBBBBBBBSSSSBBBBBBBBBBBBBBTTTTTTTTTTTTTTTPPP
PPPSSTTTSSTTTTTTTTTBBBBSMTTBBBTBBTBBBTTMTTTTTTTTTTTTTTTTTBBBBBBSSTBSSBBBBBBBBBBBBBTTTTTTTTTTTTTTTPPP
PPPSSTTTTSSTTTTTTTTBBBBSMTTBBBTBBTBBBTTMTTTTTTTTTTTTTTTTTBBBBKSSAABBSSBBBBBBBBBBBBTTTTTTTTTTTTTTTPPP
PPPSSTTTTTSSTTTTTTTBBBBSMTTBBBTBBTBBBTTMSBBBBBBBBBBBBBBBBBBBBBBSSAASSBBSSSSSSSSSSSSSSSSTTTTTTTTTTPPP
PPPTTTTTTTSSTTTTTTTBBBBSMTTTTTTTTTTTTTTMSBBBBBBBBBBBBBBBBBBBBBBBSSSSBBBSMMMMMMMMMMMMMMSTTTTTTTTTTPPP
PPPTTTTTTSSTTTTTTTKBBBBSMTTBBBTBBTBBBTTMSBBBBBBBBBBBBBBBBBBBBBBBBSSBBBBSMSSSSSSSSSSSSMSTTTTTTTTTTPPP
PPPTTTTTSSTTTTTTTTTBBBBSMTTBBBTBBTBBBTTMSBBBBBBBBBBBBBBBBBBBBBBBSSBBBBBSMSMMMMMMMMSMSMSTTTTTTTTTTPPP
PPPTTTTTSSTTTTTTTTTBBBBSMTTTTTTTTTTTTTTMSBBBBBBBBBBBBBBBBBBBBBBBBSSBBBBSMSMSSSSSSSSMSMSTTTTTTTTTTPPP
PPPTTTTTSSTTTTTTTTTBBBBSMTTBBBTBBTBBBTTMSBKBBBBBBBBBBBBBBBBBBBBBBTSSBBBSMSMSMMMMMMSMSMSTTTTTTTTTTPPP
PPPTTTTTTSSTTTTTTTTTTBBSMTTBBBTBBTBBBTTMSBBBBBBBBBBBBBBBBBBBBBBBBSSBBBBSMSMSMSSSSMSMSMSTTTTTTTTTTPPP
PPPTTTTTSSTTTTTTTTTTTBBSMTTBBBTBBTBBBTTDSBBBBBBBBBBBBBBBBBBBBBBBSSBBBBBSMSMSMSKSSMSMSMSTTTTTTTTTTPPP
PPPTTTTSSTTTTTTTTTTTTBBSMTTTTTTTTTTTTTTDSBBBBBBBBBBBBBBBBBBBBBBBBSSBBBBSMSMSMSSKSMSMSMSTTTTTTTTTTPPP
PPPTTTSSTTTTTTTTTTTTTBBSMTTTTTTTTTTTTTTMSTTTTTTTTTTTTTTTTTTTTTTTTTSSBBBSMSMSMSSSSMSMSMSTTTTTTTTTTPPP
PPPTTTTSSTTTTTTTTTTTTBBSMMMMMMMMMMMMMMMMSTTBBBBBBBBBBBBBBTTTTTTTTAASSBBSMSMSMSMMMMSMSMSTTTTTTTTTTPPP
PPPTTTTSSTTTTTTTTTTTTBBSSSSSSSSSSSSSSSSSSTTBBBBBBBBBBBBBBTTTTTTTTTAASSTSMSMSSSSSSSSMSMSTTTTTTTTTTPPP
PPPTTTTSSTTTTTTTTTTTTBSSBBBBBBBBBBBBBBBBTTTBBBBBBBBBBBBBBTTTTTTTTSSSSTTSMSMMMMMMMMMMSMSTTTTTTTTTTPPP
PPPTTTSSTTTTTTTTTTTTTBSSBBBBBBBBBBBBBBBBTTTBBBBBBBBBBBBBBTTTTTTTSSTSSTTSMSSSSSSSSSSSSMSSTTTTTTTTTPPP
PPPTTTSSTTTTTTTTTTTTTBBSSBBBBBBBBBBBBBBBTTTBBKBBBBBBBBBBBTTTTTTTTSSSSTTSMSMMMMMMMMMMMMSSSTTTTTTTTPPP
PPPTTTTSSTTTTTTTTTTKTTTTSSBBBBBBBBBBBBBBTTTBBBBBBBBBBBBBBTTKTTTTSSTSSTTSSSSSSSSSSSSSSSSTSSTTTTTTTPPP
PPPTTTSSTTTTTTTTTTTTTTTTSSBBBBBBBBBBBBBBTTTBBBBBBBBBBBBBBTTTTTTTSSAASSTTTTATATTTTTTSSTTTTSSTTTTTTPPP
PPPTTTSSATTTTTTTTTTTTTTSSBBBBBBBABAAKBBBTTTBBBBBBBBBABBBBTTKTTTSSAATTSSTAAAAAAATATSSTTTTTTSTSTTSSPPP
PPPSTASSAATTTTAATTTTTTABSSBBBBBAAAAAABBBBBBBBBBBABBAAABABAATATTATTAAASSAAASATAAAAASATAATTSSSSSSSSPPP
PPPSSASSTAAAAAAAAATTTAAASSBBABAABABBAAABBBBBBBBAAAAABAAAAAAAASSATTTAASSASTSTTTTATAAAAAATSSSSASSSSPPP
PPPTSTSSSTAAAATTAATTAATAABAAAAABBBBBBAAAABBBABAABAASBSABATTASSSSSSSATSSSSSSTTTTTTTATATSSSTTTATTSSPPP
PPPTTSSTSSTTSTTTSSSSATTBAAAABABBBBBBBBBAAAAAAAASBSBSSSBBBTTSSTTSSSSSSTSSSSSSTTTTSSSTSSSSTTTTTTTTTPPP
PPPTTSSTSSSSSSTSSSSSSTSBBASSSBBBBSSSSBBBBAAASABSSSBSSBBSSTSSTTTSSTTSSSSTSTTSSSBSSSSSSSBBBBTTTTTTTPPP
PPPSSSSSSTSSTSSSTTTTSSSSSBSSSSBBSSSSSSBBBSSBSBBSSSSSSBSSSSSTTTSSTTTAASTTTTTTSSSSBBBSBBBBBBTTTTTTTPPP
PPPSSSSSTTTTTTSTTTTTTSTSSSSBBSSSSBSSSSBBSSSBSBSSBSSBSSSTTSTTTTTSSTTTTSSTTTTTTTSBBBBBBBBBBBTTTTTTTPPP
PPPTTTSSTTTTTTTTTTTTTTTBBSSSSSSSSSSSSSSSSSBSSSSBBBBBBSTTTTTTTTTSSTTTSSTTTTTTTTBBBBBBBBBBBBTTTTTTTPPP
PPPTTTTSSTTTTTTTTTTTTTTBBSSSSSBBSSBBBSSSSSSSBSBBBBBBBTTTTTTTTTSSTTTTSSTTTTTTTTBBBBBBBBBBBBTTTTTTTPPP
PPPTTTSSTTTTTTTTTTTTTTTBSSBBBBBBBBBBBBBBSBSBBBBBBBBBBTTTTTTTTTSSTTTTTSSTTTTTTTBBBBBBBBBBBBTTTTTTTPPP
PPPTTTTSSKTTTTTTTTTTTTTBBSSBBBBBBBBBBBBBBBBBBBBBBBBBBTTTTTTTTTSSTTTTSSTTTTTTTTBBBBBBBBBBBBTTTTTTTPPP
PPPTTTTTSSTTTTTTTTTTTTTTSSTTTTTTTTTTTTTTTTTTTTTKTTTTTTTTTTTTTSSTTTTSSTTTTTTTTTTTTTTTTTTTTTTTTTTTTPPP
PPPTTTTSSTTTTTTTTTTTTTTTSSTTTTTTTTTTTTTTTTTTTTTTTTTTTTTTTTTTTSSTTTTTSSTTTTTTTTTTTTTTTTTTTTTTTTTTTPPP
PPPTTTTTSSTTTTTTTTTTTTTTTSSTTTTTTTTTTTTTTTTTTTTTTTTTTTTTTTTTTSSTTTTTTSSTTTTTTTTTTTTTTTTTTTTTTTTTTPPP
PPPTTTTSSTTTTTTTTTTTTTTTTTSSTTTTTTTTTTTTTTTTTTTTTTTTTTTTTTTTSSTTTTTTSSTTTTTTTTTTTTTTTTTTTTTTTTTTTPPP
PPPTTTSSTTTTTTTTTTTTTTTTTTSSTTTTTTTTTTTTTTTTTTTTTTTTTTTTTTTSSTTTTTTTTSSTTTTTTTTTTTTTTTTTTTTTTTTTTPPP
PPPTTTTSSTTTTTTTTTTTTTTTTSSTTTTTTTTTTTTTTTTTTTTTTTTTTTTTTTTSSTTTTTTTAASSTTTTTTTTTTTTTTTTTKTTTTTTTPPP
PPPTTTTTSSTTTTTTTTTTTTTTTTSSTTTTTTTTTTTTTTTTTTTTTTTTTTTTTTTTSSTTTTTAASSTTTTTTTTTTTTTTTTTTTTTTTTTTPPP
PPPPPPPPPPPPPPPPPPPPPPPPPPPPPPPPPPPPPPPPPPPPPPPPPPPPPPPPPPPPPPPPPPPPPPPPPPPPPPPPPPPPPPPPPPPPPPPPPPPP
PPPPPPPPPPPPPPPPPPPPPPPPPPPPPPPPPPPPPPPPPPPPPPPPPPPPPPPPPPPPPPPPPPPPPPPPPPPPPPPPPPPPPPPPPPPPPPPPPPPP
PPPPPPPPPPPPPPPPPPPPPPPPPPPPPPPPPPPPPPPPPPPPPPPPPPPPPPPPPPPPPPPPPPPPPPPPPPPPPPPPPPPPPPPPPPPPPPPPPPPP
